F 205,133,63
C 245,222,179

NO   textures/egypt_no.png
SO   textures/egypt_no.png
EA   textures/egypt_no.png
WE   textures/egypt_no.png



     11111111111111111111111111111111111111111111
111111111 111E000000000000000000011111111  1111
111111111111000001111111111000001111  11111111
111111    1111110000000011100000000011111111
1111111111110000011100111 11111001100111111111111
111111111111000001111001111110000010011111111111
111111111  1111100000000000000001111111111
11111111111111111111111111111111111111111111
