       
NO   textures/egypt_no.png  
SO   textures/egypt_so.png 	
EA   textures/egypt_ea.png		 	
WE   textures/egypt_we.png

F 20,20,20
C 20,20,20
    

11111111111111111111111111111111111111111111
111111111111E0000000000000000000111111111111
11111111111100000000111000000000111111111111
1111111111110000011111111110000000000111111111111
1111111111110000000011100000000000000111111111111
1111111111110000000001000000000000000111111111111
11111111111100000000111000000000111111111111
11111111111100001111111111110000000001111111
11111111111100000000111000000000111111111111
11111111111100000000000000000000111111111111
11111111111111111100000011111111111111111111111111
11111111111111111100000011111111111111111111111111
11111111111111111100000011111111111111111111111111
11111111111111111100000011111111111111111111111111
111111111111111000000000001111111111111
111111111111100000000000000001111111111111111
1111111100110000000000000000000000111111111111
11111100000000000000000000000000000000011111
111111000011110000001111111111100000001111111
11111110000000000001111111100000000011111111
1111111100110000000000000000000000111111111111
111111111111100000000000000001111111111111111
111111111111111000000000001111111111111
11111111111111100000000000011111
111111111111111000000000000111111
111111111111111000000000000111111
111111111111111000000000000111111
111111111111100000000000001111111
111111111110000000000000000111111
1111111111110000000000110000000111111111
1111111110000000000111110000000011111111111
1111110000000000011111111111000000000000111
111100000000000011111111111000000000000111
11110000000000001111111111111100000000000111111111
10000000000001111111111111111100000000000111111111
100000000000111111111111111111100000000000111111111
11110000000000001111111111111100000000000111111111
11100000000000011111111111000000000000111
100000000000000000000000000000000000011111111111111
100000000000000000000000000000000000011111111111111
100000000000000000000000000000000000011111111111111
111111111111111111111111111111111111111111111111