F 40,40,00
C 210,210,210

NO   textures/github.png
SO   textures/github.png
EA   textures/github.png
WE   textures/github.png




1111111111111111111111111
1110000000000000000000111
1110000000011100000000011
111000001111111110000011
111100000000000000000111
1110000011111111110000011
11100N000000000000000011
1111111111111111111111111