
NO   textures/github.png
SO   textures/github.png
EA   textures/github.png
WE   textures/github.png

C 0,0,0
F 0,0,0 

                    
 1111111        111111111
110000011      10000000001
100000001     1000000000001
 1000001     100000000000001
  11011      1000000000000001
   101        1000000100000001
   101         100001 100000001
   101111111111100000100000001
   10000000000000000000000001
   10000000000000000000000001
   1011111111111000000000001
   101         100000000001
   101        100000000001
  11011      100000000001
 1000001     1000000N0001
100000001     10000000001
11000001111111110000000011111111111111
1000000000000000000000000000000000111111111111
1000000000000000000000000000000000111111111111
11111111111100000000111000000000111111111111
11111111111100000111111111100000111111111111
111111111111000000000000000000000111111111111
11111111111100000000010000000000111111111111
11111111111100000000111000000000111111111111
11111111111100000000111000000000111111111111
11111111111100000000111000000000111111111111
1111111111110000100000000000000000001111111
1111111111110000100000000000000000001111111
11111111111100000000111000000000111111111111
11111111111100000000111000000000111111111111
11111111111100000000000000000000111111111111
11111111111111111111111111111111111111111111
