NO textures/wall_no.png
SO textures/wall_so.png 
EA textures/wall_ea.png
WE textures/wall_we.png

F 40,40,00
C 210,210,210



11111111111111111111111111111111111111111111
111111111111E0000000000000000000111111111111
11111111111100000000111000000000111111111111
1111111111110000011111111110000000000111111111111
1111111111110000000011100000000000000111111111111
1111111111110000000001000000000000000111111111111
11111111111100000000111000000000111111111111
11111111111100001111111111110000000001111111
11111111111100000000111000000000111111111111
11111111111100000000000000000000111111111111
11111111111111111100000011111111111111111111111111
11111111111111111100000011111111111111111111111111
111111111111111000000000001111111111111
11111111111111100000000000011111
111111111111111000000000000111111
111111111111111000000000000111111
11111111111111100000000000011111111111
100000000000000000000000000000000000011111111111111
100000000000000000000000000000000000011111111111111
100000000000000000000000000000000000011111111111111
11111111111111111111111111111111111111111111111111111
