
NO   textures/wall_no.png
SO   textures/wall_so.png 
EA   textures/wall_ea.png
WE   textures/wall_we.png

F 20,150,255  
C 20,150,255

                    
11111111111111111111111111111111111111111111
111111111111E0000000000000000000111111111111
11111111111100000000111000000000111111111111
11111111111100000111111111100000111111111111
11111111111100000000111000000000111111111111
11111111111100000000010000000000111111111111
11111111111100000000111000000000111111111111
11111111111100001111111111110000000001111111
11111111111100000000111000000000111111111111
11111111111100000000000000000000111111111111
11111111111111111111111111111111111111111111
