NO textures/LowPoly_no.png
SO textures/LowPoly_so.png
EA textures/LowPoly_ea.png
WE textures/LowPoly_we.png


F 40,40,00
C 210,210,210


11111111111111111111111111111111111111111111
111111111111E0000000000000000000111111111111
11111111111100000000111000000000111111111111
11111111111100000111111111100000111111111111
11111111111100000000111000000000111111111111
11111111111100000000010000000000111111111111
11111111111100000000010000000000111111111111
11111111111100000111111111100000111111111111
11111111111100000111111111100000111111111111
11111111111100000000000000000000111111111111
11111111111100000000000000000000111111111111
11111111111111111111111111111111111111111111
