NO textures/uft06.png // good
SO textures/fatal1.png // bad 
EA textures/fatal2.png // good
WE textures/fatal3.png  // bad 

F 40,40,00
C 210,210,210

11111111111111111111111111111111111111111111
111111111111E0000000000000000000111111111111
11111111111100000111001111100000111111111111
11111111111100000111001111100000111111111111
11111111111100000111001111100000111111111111
11111111111100000111001111100000111111111111
11111111111100000111001111100000111111111111
11111111111100000111001111100000111111111111
11111111111100000111001111100000111111111111
11111111111100000000000000000000111111111111
11111111111100000000000000000000111111111111
11111111111111111111111111111111111111111111
