F 205,133,63
C 245,222,179

NO   textures/test.png
SO   textures/test.png
EA   textures/test.png
WE   textures/test.png


1111111111111
1111111111111
111E000000001
1110000000001
1110000000001
1110000000001
1111111111111
